000000000000000000
020202020202020202
202020202020202020
020202020202020202
202020202020202020
020202020202020202
000000000000000000
000000000000000000
000000000000000000
000000000000000000
000000000000000000
000000000000000000
000000000000000000
000000000000000000
000000000000000000
000000001000000000
000000000900000000
000000000000000000
303030303030303030
