000000000000000000
000002222222200000
000022000000220000
000220000000022000
002200200020002200
022000000000000220
022002200022002200
002200222220022000
000220000000220000
000022222222200000
000000000000000000
000000000000000000
000000000000000000
000000000000000000
000000000000000000
000000001000000000
000000000900000000
000000000000000000
303030303030303030
