000000000000000000
020020020020020020
020020020020020020
020020020020020020
020020020020020020
020020020020020020
020020020020020020
020020020020020020
000000000000000000
000000000000000000
000000000000000000
000000000000000000
000000000000000000
000000000000000000
000000000000000000
000000001000000000
000000000900000000
000000000000000000
303030303030303030
