000000000000000000
200000000000000002
020000002200000020
002000022220000200
000202222222202000
000020000000020000
000002222222200000
000000000000000000
000000000000000000
000000000000000000
000000000000000000
000000000000000000
000000000000000000
000000000000000000
000000000100000000
000000000900000000
000000000000000000
000000000000000000
303030303030303030
