000000000000000000
222222222222222222
222222222222222222
000000000000000000
000000000000000000
000000000000000000
000000000001000000
000000000000000000
000000000000000000
000000000000000000
000000000000000000
000000000000000000
000000000000000000
000000000000000000
000000000000000000
000000000000000000
000000000900000000
000000000000000000
303030303030303030
